010000000000000000000-
010000111100000000000-
010000100100000000000-
010111100100000000000-
010100000100000000000-
010100000100000000000-
011100000111111111111-
000000000000000000000




